ActivateOleObject=Активизировать OLE объект#OLE объект#Активизировать OLE объект
ActiveObjectClose=Закрытие активного объекта#Правка#Закрытие активного объекта#Закрытие активного объекта
ActiveObjectDilate=Дилатация активного объекта#Правка#Дилатация активного объекта#Дилатация активного объекта
ActiveObjectErode=Эрозия активного объекта#Правка#Эрозия активного объекта#Эрозия активного объекта
ActiveObjectFillHoles=Заполнение дыр в активном объекте#Правка#Заполнение дыр в активном объекте#Заполнение дыр в активном объекте
ActiveObjectOpen=Открытие активного объекта#Правка#Открытие активного объекта#Открытие активного объекта
AddAllObjectsToTeach=Добавить все объекты для обучения#Классификация#Добавить все объекты на активном изображении в обучающую базу
AddMtdPane=AddMtdPane#Method#AddMtdPane#AddMtdPane
AddObjectToTeach=Добавить объект для обучения#Классификация#Добавить объект в обучающую базу - левая кнопка мыши
AddRemoveColor=Добавить/удалить цвет#Internal Actions#Добавить/удалить цвет#Добавить/удалить цвет
AddRemoveColorInterval=Добавить/удалить цветовой интервал#Internal Actions#Добавить или удалить цветовой интервал#Добавить/удалить цветовой интервал
AddSortFieldAsc=Добавить сортировку по возрастанию#База данных#Добавить сортировку по возрастанию#Добавить сортировку по возрастанию
AddSortFieldDesc=Добавить сортировку по убыванию#База данных#Добавить сортировку по убыванию#Добавить сортировку по убыванию
AddView=Добавить вид отображения в разделитель окна#Internal Actions#Добавить вид отображения в разделитель окна#Добавить вид отображения в разделитель окна
AdjustParams=AdjustParams#neuro#AdjustParams
AdvanceConnection=Расширенное подключение#База данных#Расширенное подключение#Расширенное подключение
AlignGridByCell=Выравнивание по выделенной ячейке#Вид#Выравнивание размера всех ячеек таблицы по выделенной#Выравнивание по выделенной ячейке
AlignGridByImage=Выровнять сетку по изображению#Измерения#Выровнять сетку по изображению#Выровнять сетку по изображению
AlignGridDefault=Выравнивание по умолчанию#Вид#Выравнивание размера всех ячеек таблицы по умолчанию#Выравнивание по умолчанию
AlignImages=Выравнивание изображений#Internal Actions#Выровнять изображения по совпадающим частям#Выравнивание изображений
AppExit=Выход#Файл#Закрыть приложение#Выход
ApplyFilter=Применить фильтр#База данных#Применить фильтр, повторное нажатие - отменить фильтр#Применить фильтр
ApplyLookup=Применить таблицу преобразования цветов к изображению#Internal Actions#Применить таблицу преобразования цветов к изображению
AreaSeg=AreaSeg#Filters#Area Segmentation
AssignVirtualClasses=AssignVirtualClasses#Statistics#AssignVirtualClasses
AutoAssignClasses=Автоматически разделить на классы по параметрам#Правка#Автоматически разделить на классы по параметрам#Автоматически разделить на классы по параметрам
AutoBC=Автоконтраст#Преобразования#Автоматическое контрастирование изображения
AutoBack=Auto Background#Internal Actions#Auto background#Auto background
AutoContrast=Автоконтраст#Filters#Автоконтраст
Average=Сглаживание с усреднением#Internal Actions#Применить сглаживание с усреднением к активному изображению#Сглаживание с усреднением
AviMoveFirst=Первый#AVI#Показать первый кадр
AviMoveLast=Последний#AVI#Показать последний кадр
AviMoveNext=Следующий#AVI#Показать следующий кадр
AviMovePrev=Предыдущий#AVI#Показать предыдущий кадр
AviMoveTo=Перейти#AVI#Перейти
AviPlay=Показать AVI файл#AVI#Показать AVI файл
AviSignature=AviSignature#AVI#AviSignature
AviStop=Стоп#AVI#Стоп
AxAddEventHandlers=Добавить обработчика событий#Расположение#Добавить обработчика событий#Добавить обработчика событий
AxAlignBottom=Выравнивание по нижнему краю#Расположение#Выравнивание по нижнему краю#Выравнивание по нижнему краю
AxAlignLeft=Выравнивание по левому краю#Расположение#Выравнивание по левому краю#Выравнивание по левому краю
AxAlignRight=Выравнивание по правому краю#Расположение#Выравнивание по правому краю#Выравнивание по правому краю
AxAlignTop=Выравнивание по верхнему краю#Расположение#Выравнивание по верхнему краю#Выравнивание по верхнему краю
AxChangeSize=Изменить размер элемента оформления#Расположение#Изменить размер элемента оформления#Изменить размер элемента оформления
AxControlProperties=Свойства#Расположение#Изменить свойства элемента оформления#Свойства элемента оформления
AxIncMoveSize=Изменить размер элементов оформления#Расположение#Изменить размер элементов оформления#Изменить размер элементов оформления
AxInsertControl=Вставить элемент оформления#Расположение#Вставить новый  элемент оформления#Вставить элемент оформления
AxMakeSameHeight=Выравнивание по высоте#Расположение#Выравнивание по высоте#Выравнивание по высоте
AxMakeSameSize=Выравнивание по размеру#Расположение#Выравнивание по размеру#Выравнивание по размеру
AxMakeSameWidth=Выравнивание по ширине#Расположение#Выравнивание по ширине#Выравнивание по ширине
AxSetControlSize=Установить размер элемента оформления#Расположение#Установить размер элемента оформления#Установить размер элемента оформления
AxShowControlID=Показать идентификаторы справки#Расположение#Показать идентификаторы справки#Показать идентификаторы справки
AxSpaceAccross=Горизонтальный интервал#Расположение#Выравнивание горизонтального интервала#Горизонтальный интервал
AxSpaceDown=Вертикальный интервал#Расположение#Выравнивание вертикального интервала#Вертикальный интервал
BackUpDatabase=Создать копию базы данных#База данных#Создать копию базы данных#Создать копию базы данных
BeforePrintView=Сохранение контекста#Сохранение контекста#Сохранение контекста#Сохранение контекста
BinAnd=Пересечение масок#Маски объектов#Пересечение масок
BinCleanV4=BinCleanV4#Binary#BinCleanV4
BinClose=Закрытие масок#Binary#Закрытие масок
BinCustomLogic=BinCustomLogic#Binary#BinCustomLogic
BinDeleteSmallObjects=Удаление мелких масок объектов#Binary#Удаление мелких масок объектов
BinDilate=Дилатация масок#Binary#Дилатация масок
BinDilateObjects=Дилатация масок без слияния объектов#Binary#Дилатация масок без слияния объектов
BinEditFreeLine=Произвольная линия на бинарном изображении#Редактор бинарного#Нанести произвольную линию на бинарное изображение#Произвольная линия на бинарном изображении
BinEditLine=Прямая линия на бинарном изображении#Редактор бинарного#Нанести прямую линию на бинарное изображение. Shift - дополнительные возможности.#Прямая линия на бинарном изображении
BinEditPolyline=Линия полигоном на бинарном изображении#Редактор бинарного#Линия полигоном на бинарном изображении. Завершение - двойное нажатие левой кнопки мыши#Линия полигоном на бинарном изображении
BinEditSplainLine=Линия сплайном на бинарном изображении#Редактор бинарного#Линия сплайном на бинарном изображении. Завершение - двойное нажатие левой кнопки мыши#Линия сплайном на бинарном изображении
BinErode=Эрозия масок#Binary#Эрозия масок
BinMeas=Measure Masks#Measurement#Measure object masks#Measure Masks
BinMeas_Old2006=Measure Masks#Measurement#Measure object masks#Measure Masks
BinMedian=Медиана масок#Binary#Медиана масок
BinMorphDivision=Разделение масок#Binary#Разделение масок
BinMorphDivision2=Binary Division#Binary#Division of the binary image
BinNot=Инвертировать маски#Маски объектов#Инвертировать маски объектов
BinOpen=Открытие масок#Binary#Открытие масок
BinOr=Объединение масок#Маски объектов#Объединение масок
BinReconstructBack=BinReconstructBack#Binary#BinReconstructBack
BinReconstructFore=BinReconstructFore#Binary#BinReconstructFore
BinSmooth=Сглаживание масок#Filters#Сглаживание масок
BinXor=Объединение масок без пересечения#Маски объектов#Объединение масок без пересечения
BinaryExtractPhases=Выделить маски фаз#Internal Actions#Выделить маски фаз#Выделить маски фаз
Borders=Добавить поля#Internal Actions#Нанести поля на изображение#Добавить поля
Boundary=Границы#Internal Actions#Применить фильтр Усиление Границ к текущему изображению#Границы
BoundsThreshold=Бинаризация по границам#Filters#Бинаризация по границам
BranchSplit=BranchSplit#Filters#BranchSplit#BranchSplit
BreakAtNextStatement=Точка останова на следующей строке#For Developers#Точка останова на следующей строке#Точка останова на следующей строке
BrightContrast=Яркость&Контраст#Internal Actions#Изменить яркость и контраст активного изображения#Яркость&Контраст
Burn=Затемнение#Преобразования#Затемнить участки изображения#Затемнение
CalcMeasResult=Измерить объекты#Измерения#Измерить или перемерить нанесенные объекты#Измерить объекты
CalcStat=Статистический анализ#Classification#Статистический анализ#Статистический анализ
CanConvertToGray=CanConvertToGray#Вид#CanConvertToGray#CanConvertToGray
Cancel=Отмена#База данных#Отмена#Отмена
Canny=CannyThreshold#Thresholding#CannyThreshold
ChoiceQuery=Выбрать запрос#База данных#Выбрать запрос#Выбрать запрос
ChooseFilter=Выбрать фильтр#База данных#Выбрать фильтр#Выбрать фильтр
ChooseObject=Выбрать объект...#Правка#Выбрать объект#Выбрать объект
ChowKaneko=Бинаризация Шов/Канеко#Filters#Бинаризация Шов/Канеко
Cipher=Cipher#Image#Cipher Image#Cipher Image
ClassCreate=Создать класс#Classification#Создать новый класс#Создать класс
ClassDelete=Удалить класс#Classification#Удалить выбранный класс#Удалить класс
ClassRecolor=Изменить цвет класса#Classification#Изменить цвета класса#Изменить цвет класса
ClassRename=Переименовать класс#Classification#Переименовать класс#Переименовать класс
ClassesArrange=Упорядочить классы#Classification#Упорядочить классы
ClassifyNeuro=ClassifyNeuro#neuro#ClassifyNeuro
ClassifyObjectList=ClassifyObjectList#ClassBase#ClassifyObjectList
ClassifyObjects=Классифицировать объекты#Классификация#Автоматическая классификация всех объектов на активном изображении
CleanFrame=CleanFrame#Filters#CleanFrame
ClipboardAvail=Буфер обмена доступен#Правка#Буфер обмена доступен#Буфер обмена доступен
Clone=Дубликат изображения#Изображение#Создать дубликат изображения#Дубликат изображения
Close=Закрытие#Internal Actions#Применить фильтр Закрытие к активному изображению#Закрытие
CloseByReconstruction=Close by Reconstruction#Filters#Close by reconstruction
CloseByReconstructionAAM=Закрытие с реконструкцией#Преобразования#Закрытие с реконструкцией
CloseQuery=Закрыть запрос#База данных#Закрыть запрос#Закрыть запрос
Collect=Focus Enhancement#Enhance#Focus Enhancement#Focus Enhancement
CollectByDisp=Расширенный фокус по Disp#Internal Actions#Создать результирующее изображение по Disp#Расширенный фокус по Disp
CollectByMasks=Расширенный фокус по маскам#Internal Actions#Создать результирующее изображение по маскам#Расширенный фокус по маскам
CollectByPoints=Расширенный фокус  по точкам#Internal Actions#Создать результирующее изображение по точкам#Расширенный фокус  по точкам
ColorBalance=Цветовой баланс#Filters#Коррекция цвета изображения
ColorSeg=ColorSeg#Filters#Color Segmentation
Comment=Комментарий#Редактор#Нанести комментарий: левая кнопка мыши. Ctrl+Enter: переход строки. Enter: завершить.#Комментарий
CompareImages=Сравнить изображения#Изображение#Поворот: PgDn, PgUp; перемещение: Ctrl+стрелки; изменение размера: Shift+стрелки, выход: Esc#Сравнить изображения
CompareResut=Stitch from Splitter#Image#Create new image by combining two split images#Stitch from splitter
CompareScreen=Захватить вид сравнения#Internal Actions#Захват вида сравнения#Захватить вид сравнения
ContinueCurves=ContinueCurves#Thresholding#ContinueCurves
ConvertImage=Конвертирование изображения...#Изображение#Перевести изображение в другую цветовую модель#Конвертирование изображения
ConvertVT4Dbase=Конвертировать базу данных VT4#База данных#Конвертировать базу данных VT4 в формат, используемый в VT5#Конвертировать базу данных VT4
CopyAllMeasCell=Копировать все ячейкиl#Измерения#Копировать все ячейки#Копировать все ячейки
CopyImageToObjects=Обновить список объектов#Преобразования#Обновить список объектов с изображения
CopySelectedMeasCell=Копировать выбранные ячейкиl#Измерения#Копировать выбранные ячейки#Копировать выбранные ячейки
CreateBinaryBySelection=Создать маски по рамке#Binary#Создать маски по рамке#Создать маски по рамке
CreateFilter=Добавить условие фильтра#База данных#Добавить новое условие фильтра по выбранному полю#Добавить условие фильтра
CreateImageByList=Заливка фона#Правка#Заливка областей изображения, не являющихся объектами#Заливка фона
CreateImageByView=Объединить видимые элементы#Изображение#Объединить элементы из активной части окна документа#Объединить видимые элементы
CreateNewParam=Создать новый параметр измерений#Internal Actions#Создать новый параметр для ручных измерений#Создать новый параметр измерений
CreatePloidClassFile=...#Measurement#Measurement#
CreateSelectionByBinary=Создать рамку по маскам#Binary#Создать рамку по маскам#Создать рамку по маскам
CreateStatObject=CreateStatObject#Статистика#CreateStatObject
CreateStatTable=Create Statistics Table#Statistics#Create statatistics table
CreateTD=Add to Statistics#Measurement#Add data to statistics#Add Data to Statistics
CreateTD_Old2006=Add to Statistics#Measurement#Add data to statistics#Add Data to Statistics
Crop=Вырезать фрагмент#Изображение#Вырезать фрагмент изображения#Вырезать фрагмент
CustomizeStatTable=Customize Statistics Table#Statistics#Customize statatistics table
CutDocBySel=Обрезать данные в документе по рамке#Изображение#Обрезать данные в документе по рамке#Обрезать данные в документе по рамке
DBFindText=Поиск текста...#База данных#Поиск текста#Поиск текста
DBFindTextNext=Найти далее#База данных#Найти далее#Найти далее
DBaseInfo=Свойства базы данных...#База данных#Свойства базы данных#Свойства базы данных
DataShowContents=Показать сожержание данных...#For Developers#Показать сожержание данных#Показать сожержание данных
DataTableToExcel=Data Table to Excel#Measurement#Send current Data Table to MS Excel#Send Data Table to MS
DataTableToExcel1=Data Table to Excel#Measurement#Send current Data Table to MS Excel#Send Data Table to MS
DataToExcelAvail=DataToExcelAvail#Правка#DataToExcelAvail#DataToExcelAvail
DataToExcelMaster=Send Data to MS Excel#Measurement#Send current Object List to MS Excel#Send Data to MS Excel
DataUnselect=Снять выделение всех объектов#Internal Actions#Снять выделение всех объектов#Снять выделение всех объектов
DeactivateOleObject=Сделать неактивным OLE объект#OLE объект#Сделать неактивным OLE объект
DeleteObjectsFromStatTable=Delete Objects From Statistics Table#Statistics#Delete objects from statatistics table
DeleteRecord=Удалить запись#База данных#Удалить запись#Удалить запись
DeleteRecords=Удалить записи#База данных#Удалить#Удалить записи
Dilate=Дилатация#Internal Actions#Применить фильтр Дилатация к активному изображению#Дилатация
DilateOnImage=DilateOnImage#Filters#DilateOnImage
DoTrigger=Программный триггер#Ввод#Эмуляция срабатывания внешнего сигнала#Программный триггер
Dodge=Осветление#Преобразования#Осветлить участки изображения#Осветление
DoubleEdge=DoubleEdge thresholding#Filters#DoubleEdge thresholding
DriverDlg=Настройки драйвера камеры#Ввод#Настройки драйвера камеры#Настройки драйвера камеры
DumpMemory=Dump Memory#File#Dump memory#Dump Memory
EditArrow=Стрелка#Редактор#Нанести стрелку на изображение: левая кнопка мыши#Стрелка
EditCircle=Окружность#Редактор#Рисовать: левая или правая кнопка мыши. Ctrl-Пипетка.#Окружность
EditCircleArrow=Set Circle Arrow#Редактор#Set circle arrow to the image#Circle arrow
EditCopy=Копировать#Правка#Копирование элемента в буфер обмена#Копировать
EditCut=Вырезать#Правка#Переместить  элемент в буфер обмена#Вырезать
EditFreeLine=Произвольная линия#Редактор#Рисовать: левая или правая кнопка мыши. Ctrl-Пипетка.#Произвольная линия
EditLine=Прямая линия#Редактор#Рисовать: левая или правая кнопка мыши. Shift-доп. возможности. Ctrl-Пипетка.#Прямая линия
EditMarker=Произвольный маркер#Измерения#Калибровочный маркер произвольной длины#Произвольный маркер
EditPaste=Вставить#Правка#Вставить элемент из буфера обмена#Вставить
EditPolyline=Ломаная линия#Редактор#Рисовать: левая или правая кнопка мыши. Ctrl-Пипетка. Завершение-двойное нажатие левой кнопки.#Ломаная линия
EditRecord=Редактировать запись#База данных#Редактировать запись#Редактировать запись
EditRect=Прямоугольник#Редактор#Рисовать: левая или правая кнопка мыши. Shift-доп. возможности. Ctrl-Пипетка.#Прямоугольник
EditSplainLine=Линия сплайном#Редактор#Рисовать: левая или правая кнопка мыши. Ctrl-Пипетка. Завершение-двойное нажатие левой кнопки.#Линия сплайном
EditTestDB=EditTestDB#Tests#edit tests database#EditTestDB
Emboss=Рельеф#Internal Actions#Создать рельефное изображение#Рельеф
EmptyClassifier=Очистить обучающую базу#Классификация#Очистка обучающей базы классификатора
EmptyDBField=Очистить поле#База данных#Удалить данные из поля#Очистить поле
EmptyFileOpen=EmptyFileOpen#Internal Scripts#EmptyFileOpen#
EmptyFileOpenLight=EmptyFileOpenLight#Internal Scripts#EmptyFileOpenLight#
EntropyThreshold=Бинаризация по энтропии#Filters#Бинаризация по критерию минимума энтропии
EnumActions=Список акций...#For Developers#Список акций#Список акций
EqualContrasts=Выравнивание контраста#Преобразования#Выравнивание контраста двух изображений#Выравнивание контраста
EqualHists=Выравнивание гистограмм#Преобразования#Выравнивание гистограммы двух изображений#Выравнивание гистограмм
Equalize=Выравнивание#Internal Actions#Выровнять активное изображение#Выравнивание
EqualizeAllObj=Контраст хромосом#Преобразования#Контрастирование всех хромосом
EqualizeObj=Контраст хромосомы#Преобразования#Контрастирование указанной хромосомы - левая кнопка мыши
Erode=Эрозия#Internal Actions#Применить фильтр Эрозия к активному изображению#Эрозия
Even=Выравнивание фона#Internal Actions#Выравнивание фона#Выравнивание фона
EvenAAM=Выравнивание фона#Преобразования#Выравнивание фона
EvenByEdge=EvenByEdge#Filters#EvenByEdge
EvenV=Выравнивание фона#Преобразования#Выравнивание фона
ExecuteSQL=Выполнить запрос на SQL#База данных#Выполнить запрос на SQL#Выполнить запрос на SQL
Expansion=Выделить цветовые каналы#Изображение#Выделить отдельные цветовые каналы цветного изображения#Выделить цветовые каналы
ExportReportToJPEG=Экспорт в JPEG#Экспорт в JPEG#Экспорт активного документа в JPEG#Экспорт в JPEG
ExportScript=ExportScript#Method#ExportScript#ExportScript
ExportStatTable=Сохранить таблицу данных в текстовом формате#Измерения#Сохранить таблицу данных в текстовом формате
ExtractPhase=Выделить фазу#Internal Actions#Выделить фазу#Выделить фазу
ExtractPhases=Выделить фазы#Internal Actions#Выделить фазы#Выделить фазы
FastAverage=Быстрое сглаживание с усреднением#Internal Actions#Применить быстрое сглаживание с усреднением к изображению#Быстрое сглаживание с усреднением
FastFindPhasesColor=FastFindPhasesColor#Thresholding#FastFindPhasesColor
FastGradient=Быстрый градиент#Фильтры#Применить фильтр Быстрый градиент к активному изображению#Быстрый градиент
FastUnsharpenMask=Быстрое усиление резкости#Фильтры#Применить быстрое усиления резкости к активному изображению#Быстрое усиление резкости
FieldProperties=Свойства поля...#База данных#Свойства поля#Свойства поля
FileClose=Закрыть документ#Файл#Закрыть активный документ#Закрыть документ
FileCloseAll=Закрыть все документы#Файл#Закрыть все документы#Закрыть все документы
FileNew=Новый документ#Файл#Создать новый документ#Новый документ
FileOpen=Открыть...#Файл#Открыть файл#Открыть
FileSave=Сохранить#Файл#Сохранить#Сохранить
FileSaveAs=Сохранить как...#Файл#Сохранить документ с новым именем#Сохранить как
FileSaveView=Сохранить вид окна...#Файл#Сохранить текущий вид окна документа в файл#Сохранить вид окна
FileSaveViewScript=Save View...#File#Save the current view as file#Save View
FileSaveViewScript_Old2006=Save View...#File#Save the current view as file#Save View
FileSendEMail=Отправить по E-Mail...#Файл#Отправить текущий документ по e-mail#Отправить по E-Mail
FileSendView=Отправить вид окна...#Файл#Отправить текущий вид окна документа по E-Mail#Отправить вид окна
FileSendViewScript=Send View...#File#Send the current view by E-Mail#Send View
FileSendViewScript_Old2006=Send View...#File#Send the current view by E-Mail#Send View
FillHolesBin=Заполнение пустот в масках объектов#Binary#Заполнение пустот в масках объектов#Заполнение пустот в масках объектов
FilterObjectList=FilterObjectList#Edit#FilterObjectList#FilterObjectList
FilterOrganizer=Редактор фильтров...#База данных#Редактор фильтров#Редактор фильтров
FilterStatTable=Filter Statistics Table#Statistics#Filter statatistics table
FindBorderObjects=Поиск объектов, граничащих с рамкой#Правка#Поиск объектов, граничащих с рамкой#Поиск объектов, граничащих с рамкой
FindCircles2=FindCircles2#Filters#FindCircles2
FindCircles3=FindCircles3#Filters#FindCircles3
FindCurves=FindCurves#Thresholding#FindCurves
FindNuclei=FindNuclei#Filters#Find Nuclei
FindPhasesColor=FindPhasesColor#Filters#FindPhasesColor
FindPhasesGray=Поиск фаз на grayscale#Filters#FindPhasesGray
Fit2Image=Размер окна по изображению#Вид#Установить размер окна документа по изображению#Размер окна по изображению
FitDoc2Screen=Размер изображения по экрану#Вид#Устанавить размер изображения по размеру экрана#Размер изображения по экрану
FitToPage=По размеру окна#Печать#Установить размер шаблона отчета по размеру окна#По размеру окна
FitToPageWidth=По ширине#Печать#Установить ширину шаблона отчета по ширине окна#По ширине
FloodFill=Заливка#Редактор#Заливка однородным цветом: правая или левая кнопка мыши. Ctrl-Пипетка.#Заливка
FormPressCancel=Form Press Cancel#Layout#Form Press Cancel#Form Press Cancel
FormPressOK=Form Press OK#Layout#Form Press OK#Form Press OK
Fourier=Прямое преобразование Фурье#FFT#Провести прямое преобразование Фурье на активном изображении#Прямое преобразование Фурье
FourierBack=Обратное преобразование Фурье#FFT#Провести обратное преобразование Фурье на активном изображении#Обратное преобразование Фурье
FourierHilight=Выделить области спектра#FFT#Выделить области со спектра  Фурье#Выделить области спектра
FourierMode=Режим FFT#FFT#Начало и завершение режима быстрого преобразования Фурье#Режим FFT
FourierRemove=Удалить области спектра#FFT#Удалить области со спектра Фурье#Удалить области спектра
FourierSelectCenter=Выделить центр изображения Фурье#FFT#Нанести рамку на центр изображения Фурье#Выделить центр изображения Фурье
FourierSelectEllipse=Эллиптическая рамка на изображении Фурье#FFT#Нанести рамку эллиптической формы на изображение Фурье#Эллиптическая рамка на изображении Фурье
FourierSelectFree=Произвольная рамка на изображении Фурье#FFT#Нанести рамку произвольной формы на изображение Фурье#Произвольная рамка на изображении Фурье
FreeTransformation=Свободное преобразование#Изображение#Поворот: PgDn, PgUp; перемещение: Ctrl+стрелки; изменение размера: Shift+стрелки, выход: Esc#Свободное преобразование
Freeze=Заморозка окна#For Developers#Заморозить окно программы
FuzzySetsThreshold=Бинаризация нечетких множеств#Filters#Бинаризация по границе нечетких множеств
GalleryOptions=Установки галереи...#База данных#Установки галереи#Установки галереи
GenerateReportByQuery=Создать отчет по запросу#База данных#Создать отчет по запросу#Создать отчет по запросу
GetObjectDescription=Информация#ClassBase#Информация
Gradient=Градиент#Filters#Градиент
GrayThresholding=Выделение масок на полутоновом#Фильтры#Выделение масок на полутоновом#Выделение масок на полутоновом
GrayThresholdingAllPhases=threshold all phases on image#Phase analysis#threshold all phases on image
GrayThresholdingBin=Выделить маски на полутоновом#Фильтры#Выделить маски на полутоновом#Выделить маски на полутоновом
GrayThresholdingBinAuto=Выделить маски на полутоновом#Фильтры#Выделить маски на полутоновом#Выделить маски на полутоновом
GrayThresholdingBinAutoMute=Выделить маски на полутоновом#Фильтры#Выделить маски на полутоновом#Выделить маски на полутоновом
GrayThresholdingPhase=Полутоновая бинаризация с получением фазы#Фазовый анализ#Полутоновая бинаризация с получением фазы
GridMoveParam=Переместить колонку#---#Переместить колонку#Переместить колонку
GridObjectHeight=Высота строки#---#Высота строки#Высота строки
GridParamWidth=Ширина колонки#---#Ширина колонки#Ширина колонки
GridRenameParam=Переименовать параметр#---#Переименовать параметр#Переименовать параметр
HelpAbout=О программе...#Справка#Информация о программе#О программе
HelpContext=Контекстная справка#Справка#Информация по выбранной кнопке, пункту меню или окну#Контекстная справка
HelpIndex=Справка...#Справка#Показать окно помощи#Справка
HideDockBars=Hide Dockbars#Internal Scripts#Hide dockbars#
HideDockBars_Old2006=Hide Dockbars#Internal Scripts#Hide dockbars#
HideStatTableColumn=Hide Statistics Table Column#Statistics#Hide statatistics table column
ImageAdd=Сложение изображений#Преобразования#Сложение изображений
ImageBySel=Обрезать по рамке#Изображение#Обрезать изображение по рамке#Обрезать по рамке
ImageCombine=Комбинировать изображения#Filters#Комбинировать два изображения
ImageDiff=Разность изображений#Преобразования#Разность изображений
ImageDiv=Деление изображений#Преобразования#Деление изображений
ImageMul=Умножение изображений#Преобразования#Умножение изображений
ImageSub=Вычитание изображений#Преобразования#Вычитание изображений
ImageSubEx=Вычитание изображений#Преобразования#Вычитание изображений
ImageSubLight=Вычитание фона#Преобразования#Устранение неровностей фона на изображении
ImageTransform=Масштабирование и поворот изображения#Правка#Масштабирование и поворот изображения#Масштабирование и поворот изображения
ImposingDivision=Разделение наложений#Карио#Обведите контур хромосомы при нажатой левой кнопке мыши, по завершении отпустите кнопку#Разделение наложений
Init_Master=Init_Master#Скрипты#Init_Master
Init_Master0=Init_Master0#Скрипты#Init_Master0
Init_Master_Old2006=Init_Master_Old2006#Скрипты#Init_Master_Old2006
InputImage=Способ получения изображения#Ввод#Выбор способа получения изображения#Способ получения изображения
InputImageInCurrentDoc=Ввод изображения в активный документ#По умолчанию#Ввести изображение в активный документ#Ввод изображения в активный документ
InputVideo=Видео#Ввод#Видео#Видео
InsertAviObject=Добавить AVI-объект#AVI#Добавление AVI-объекта
InsertOleObject=Вставить OLE объект в документ#OLE объект#Вставить OLE объект в документ
InsertOleObjectFromClipboard=Вставить OLE объект из буфера в документ#OLE объект#Вставить OLE объект из буфера в документ
InsertOleObjectFromClipboardToExist=Вставить OLE объект из буфера#OLE объект#Вставить OLE объект из буфера
InsertOleObjectToExist=Вставить OLE объект#OLE объект#Вставить  OLE объект
InsertRecord=Добавить запись#База данных#Добавить запись#Добавить запись
InteractiveScroll=Прокрутка изображения#Вид#Удерживая левую кнопку мыши, просматривайте изображение в любом направлении#Прокрутка изображения
InteractiveZoom=Интерактиваная лупа#Вид#Левой кнопкой мыши открыть выпадающий список, движком изменить увеличение#Интерактиваная лупа
IterationThreshold=Итерационная бинаризация#Filters#Бинаризация с использованием итерационной границы
JoinAllObjects=Join all objects#Edit#Join all objects#Join all objects
Kirsch=Кирш#Фильтры#Применить фильтрацию по методу Кирша к активному изображению#Кирш
Laplas=Лаплас#Фильтры#Применить фильтрацию методом Лапласа к активному изображению#Лаплас
LinesThreshold=LinesThreshold#Thresholding#LinesThreshold
LoadDatabase=Загрузить новую базу данных#База данных#Загрузить новую базу данных#Загрузить новую базу данных
LoadMtdContent=LoadMtdContent#Method#LoadMtdContent#LoadMtdContent
LoadViewState=Загрузить сотояние вида отображения#Internal Actions#Загрузить сотояние вида отображения#Загрузить сотояние вида отображения
LocalContrast=Local Contrast#Enhance#Local contrast#Local Contrast
LocalEqualize=Локальное выравнивание#Фильтры#Выровнять активное изображение с использованием локального фильтра#Локальное выравнивание
LocalMax=Бинаризация локального максимума#Filters#Бинаризация локального максимума
LocalMin=Бинаризация локального минимума#Filters#Бинаризация локального минимума
MacroRecord=Записать новый макрос#Tools#Записать новый макрос#Записать новый макрос
MagickStick=Волшебная палочка#Рамки#Shift-добавление, Alt-вычитание#Волшебная палочка
MakeObjectsNonVirtual=MakeObjectsNonVirtual#Edit#MakeObjectsNonVirtual#MakeObjectsNonVirtual
MakeObjectsVirtual=MakeObjectsVirtual#Правка#MakeObjectsVirtual#MakeObjectsVirtual
ManualClassifyObjects=Ручная классификация#Классификация#Ручная классификация объектов. Укажите класс выбранного объекта
MapObjectsToImage=MapObjectsToImage#Правка#MapObjectsToImage#MapObjectsToImage
MasterModeDataBase=Database#Tools#Switch to Database mode#Switch to Database
MasterModeDataBase_Old2006=Database#Tools#Switch to Database mode#Switch to Database
MasterModeMethod=Method#Tools#Switch to Method mode#Switch to Method
Master_states=Master_states#Скрипты#Master_states
Master_states_Old2006=Master_states_Old2006#Скрипты#Master_states_Old2006
MeanEV=Сглаживание по яркости#Filters#Сглаживание по яркости
MeanEVV=Сглаживание#Преобразования#Сглаживание
MeanKNV=Сглаживание по размеру#Filters#Сглаживание по размеру
MeasManualAngle2Line=Угол по 2 линиям#Измерения#Измерить угол по двум линиям#Угол по 2 линиям
MeasManualAngle2LineScript=MeasManualAngle2LineScript#Скрипты#MeasManualAngle2LineScript
MeasManualAngle2LineScript_Old2006=MeasManualAngle2LineScript_Old2006#Скрипты#MeasManualAngle2LineScript_Old2006
MeasManualAngle3Point=Угол по 3 точкам#Измерения#Измерить угол по 3 точкам#Угол по 3 точкам
MeasManualAngle3PointScript=MeasManualAngle3PointScript#Скрипты#MeasManualAngle3PointScript
MeasManualAngle3PointScript_Old2006=MeasManualAngle3PointScript_Old2006#Скрипты#MeasManualAngle3PointScript_Old2006
MeasManualBrokenLine=Длина ломаной линии#Измерения#Измерить длину ломаной линии#Длина ломаной линии
MeasManualCount=Подсчет количества#Измерения#Подсчет количества объектов. Левая кнопка мыши-подсчет, правая-завершение.#Подсчет количества
MeasManualCycle2=Радиус по 2 точкам#Измерения#Измерить радиус по 2 точкам#Радиус по 2 точкам
MeasManualCycle2Script=MeasManualCycle2Script#Скрипты#MeasManualCycle2Script
MeasManualCycle2Script_Old2006=MeasManualCycle2Script_Old2006#Скрипты#MeasManualCycle2Script_Old2006
MeasManualCycle3=Радиус по 3 точкам#Измерения#Измерить радиус по 3 точкам#Радиус по 3 точкам
MeasManualCycle3Script=MeasManualCycle3Script#Скрипты#MeasManualCycle3Script
MeasManualCycle3Script_Old2006=MeasManualCycle3Script_Old2006#Скрипты#MeasManualCycle3Script_Old2006
MeasManualFreeLine=Длина произвольной линии#Измерения#Измерить длину произвольной линии#Длина произвольной линии
MeasManualFreeLineScript=MeasManualFreeLineScript#Скрипты#MeasManualFreeLineScript
MeasManualFreeLineScript_Old2006=MeasManualFreeLineScript_Old2006#Скрипты#MeasManualFreeLineScript_Old2006
MeasManualLine=Длина прямой линии#Измерения#Измерить длину прямой линии#Длина прямой линии
MeasManualLineScript=MeasManualLineScript#Скрипты#MeasManualLineScript
MeasManualLineScript_Old2006=MeasManualLineScript_Old2006#Скрипты#MeasManualLineScript_Old2006
MeasManualParallel=Расстояние между параллельными линиями#Измерения#Расстояние между параллельными линиями. Левая кнопка мыши-измерить, правая-закончить.#Расстояние между параллельными линиями
MeasManualSpline=Длина линии сплайном#Измерения#Измерить длину линии сплайном#Длина линии сплайном
MeasManualSplineScript=MeasManualSplineScript#Скрипты#MeasManualSplineScript
MeasManualSplineScript_Old2006=MeasManualSplineScript_Old2006#Скрипты#MeasManualSplineScript_Old2006
MeasureBin=Измерить маски#Фильтры#Измерить маски#Измерить маски
MeasurePhases=Измерить фазы по маскам#Фильтры#Измерить фазы по маскам#Измерить фазы по маскам
MeasurePhasesLight=Измерить фазы по маскам#Фильтры#Измерить фазы по маскам#Измерить фазы по маскам
Median=Сглаживание по медиане#Фильтры#Применить сглаживание по медиане к активному изображению#Сглаживание по медиане
Merge=Объединить цветовые каналы#Правка#Объединить цветовые каналы изображения#Объединить цветовые каналы
MethodOpen=MethodOpen#Method#MethodOpen#MethodOpen
MethodRedo=MethodRedo#Method#MethodRedo#MethodRedo
MethodStart=MethodStart#Скрипты#MethodStart
MethodStart_Old2006=MethodStart_Old2006#Скрипты#MethodStart_Old2006
MethodUndo=MethodUndo#Method#MethodUndo#MethodUndo
MinBinaryThreshold=Бинаризация по минимизации#Filters#Бинаризация по минимизации ошибки
MirrorHorz=Горизонтальное отражение#Изображение#Горизонтальное отражение изображения#Горизонтальное отражение
MirrorVert=Вертикальное отражение#Изображение#Вертикальное отражение изображения#Вертикальное отражение
MorphDivideExBin=Расширенное морфологическое разделение масок#Binary#Расширенное морфологическое разделение масок#Расширенное морфологическое разделение масок
MoveFirst=Первая запись#База данных#Первая запись#Первая запись
MoveLast=Последняя запись#База данных#Последняя запись#Последняя запись
MoveNext=Следующая запись#База данных#Следующая запись#Следующая запись
MovePrev=Предыдущая запись#База данных#Предыдущая запись#Предыдущая запись
MtdAddItem=MtdAddItemt#Method#MtdAddItem#MtdAddItem
MtdClearMethod=Удалить все шаги#Методика#Удаление всех шагов методики#Удаление всех шагов методики
MtdCopyMethod=Копировать методику#Методика#Копировать методику#Копировать методику
MtdCreateMethod=Новая методика#Методика#Новая методика#Новая методика
MtdDeleteMethod=Удалить методику#Методика#Удалить методику#Удалить методику
MtdInsertMsgStep=Вставить сообщение#Методика#Вставить сообщение в активную методику#Вставить сообщение в активную методику
MtdList=Список методик#Методика#Список методик#Список методик
MtdRemoveItem=MtdRemoveItemt#Method#MtdRemoveItem#MtdRemoveItem
MtdRunStop=Старт методики#Методика#Запустить или остановить методику#Старт методики
MtdSaveMethod=MtdSaveMethod#Method#MtdSaveMethod#MtdSaveMethod
Negative=Негатив#Преобразования#Преобразовать активное изображение в негатив#Негатив
NewDBFromTemplate=Новая база из активной...#База данных#Создать новую базу на основе активной#Новая база из активной
NewDataBase=New Database...#Database#Create new database#New Database
NewDoc=New Document#File#Create a new document#New Document
NewPhase=Сделать фон новой фазой#Фазовый анализ#Сделать фон новой фазой
NewPhasePacked=Make new phase from background on single binary#Phase analysis#Make new phase from backgroundfrom background on single binary
NewQueryScript=New Query...#Database#Create new query#New Query
NewQueryScript_Old2006=New Query...#Database#Create new query#New Query
NormalizeParameters=Нормализация параметров#Классификация#Нормализация параметров#Нормализация параметров
Null_Action=Null#---#Null#Null
ObjectClassifyByLimits=Классифицировать объекты по пределам#Правка#Классифицировать объекты в соответствии с установленными пределами#Классифицировать объекты по пределам
ObjectCutFrame=Отброс объектов от рамки#Правка#Отброс объектов от рамки#Отброс объектов от рамки
ObjectDelete=Удалить элемент(ы)#Правка#Удаление элементов, выбранных в окне Содержание#Удалить выбранные элементы
ObjectDeleteSelection=Удалить активный объект#Правка#Удаление активного объекта#Удалить активный объект
ObjectDrag=ObjectDrag#По умолчанию#ObjectDrag#ObjectDrag
ObjectDrop=ObjectDrop#По умолчанию#ObjectDrop#ObjectDrop
ObjectEditor=Карандаш#Измерения#Левая кнопка мыши-рисование, правая-стирание#Карандаш
ObjectEditorScript=ObjectEditorScript#Скрипты#ObjectEditorScript
ObjectEditorScript_Old2006=ObjectEditorScript_Old2006#Скрипты#ObjectEditorScript_Old2006
ObjectEditorSpec=Область на изображении#Измерения#Левая кнопка мыши-рисование#Область на изображении
ObjectEllipse=Круглый объект#Измерения#Shift-добавление, Alt-вычитание#Круглый объект
ObjectEllipseDirect=Эллиптический направленный объект#Измерения#Shift-добавление, Alt-вычитание#Эллиптический направленный объект
ObjectEllipseDirectScript=ObjectEllipseDirectScript#Скрипты#ObjectEllipseDirectScript
ObjectEllipseDirectScript_Old2006=ObjectEllipseDirectScript_Old2006#Скрипты#ObjectEllipseDirectScript_Old2006
ObjectEllipseFixed=Эллиптический фиксированный объект#Измерения#Shift-добавление, Alt-вычитание#Эллиптический фиксированный объект
ObjectEllipseFixedScript=ObjectEllipseFixedScript#Скрипты#ObjectEllipseFixedScript
ObjectEllipseFixedScript_Old2006=ObjectEllipseFixedScript_Old2006#Скрипты#ObjectEllipseFixedScript_Old2006
ObjectEllipseScript=ObjectEllipseScript#Скрипты#ObjectEllipseScript
ObjectEllipseScript_Old2006=ObjectEllipseScript_Old2006#Скрипты#ObjectEllipseScript_Old2006
ObjectFilter=Фильтрация объектов#Правка#Фильтрация объектов#Фильтрация объектов
ObjectFree=Произвольный объект#Измерения#Shift-добавление, Alt-вычитание#Произвольный объект
ObjectFreeScript=ObjectFreeScript#Скрипты#ObjectFreeScript
ObjectFreeScript_Old2006=ObjectFreeScript_Old2006#Скрипты#ObjectFreeScript_Old2006
ObjectLine=Линейный объект#Измерения#Нанести линейный объект#Линейный объект
ObjectLoad=Загрузить элемент#Файл#Загрузить новый элемент#Загрузить элемент
ObjectMagickStick=Волшебная палочка#Измерения#Shift-добавление, Alt-вычитание#Волшебная палочка
ObjectMagickStickScript=ObjectMagickStickScript#Скрипты#ObjectMagickStickScript
ObjectMagickStickScript_Old2006=ObjectMagickStickScript_Old2006#Скрипты#ObjectMagickStickScript_Old2006
ObjectMoveToApp=Переместить элемент в приложение#Правка#Перемещение элемента из документа в приложение#Переместить элемент в приложение
ObjectMoveToDoc=Переместить элемент в документ#Правка#Перемещение элемента из приложения в документ#Переместить элемент в документ
ObjectNew=Новый элемент...#Правка#Создание нового элемента в активном документе#Новый элемент
ObjectOrganize=Организовать элементы#Правка#Организовать элементы#Организовать элементы
ObjectPolyLine=Объект ломаной линией#Измерения#Нанести объект в форме ломаной линии#Объект ломаной линией
ObjectProperties=Свойства элемента#Правка#Свойства элемента#Свойства элемента
ObjectRect=Прямоугольный объект#Измерения#Shift-добавление, Alt-вычитание, Ctrl-перекрестье#Прямоугольный объект
ObjectRectDirect=Прямоугольный направленный объект#Измерения#Shift-добавление, Alt-вычитание#Прямоугольный направленный объект 
ObjectRectDirectScript=ObjectRectDirectScript#Скрипты#ObjectRectDirectScript
ObjectRectDirectScript_Old2006=ObjectRectDirectScript_Old2006#Скрипты#ObjectRectDirectScript_Old2006
ObjectRectFixed=Прямоугольный фиксированный объект#Измерения#Shift-добавление, Alt-вычитание#Прямоугольный фиксированный объект
ObjectRectFixedScript=ObjectRectFixedScript#Скрипты#ObjectRectFixedScript
ObjectRectFixedScript_Old2006=ObjectRectFixedScript_Old2006#Скрипты#ObjectRectFixedScript_Old2006
ObjectRectScript=ObjectRectScript#Скрипты#ObjectRectScript
ObjectRectScript_Old2006=ObjectRectScript_Old2006#Скрипты#ObjectRectScript_Old2006
ObjectRename=Переименовать элемент...#Правка#Переименование элемента#Переименовать элемент
ObjectSave=Сохранить элемент как...#Файл#Сохранение элемента в отдельном файле#Сохранить элемент как
ObjectScissors=Ножницы#Правка#Ножницы для разделения объектов#Ножницы
ObjectScissorsScript=ObjectScissorsScript#Скрипты#ObjectScissorsScript
ObjectScissorsScript_Old2006=ObjectScissorsScript_Old2006#Скрипты#ObjectScissorsScript_Old2006
ObjectSelect=Выбрать элемент#Правка#Выбор существующего элемента#Выбрать элемент
ObjectSetClass=Назначить класс#Classification#Назначить класс для выбранного обекта#Назначить класс
ObjectSetClassDirect=Назначить класс для объекта#Classification#Назначить активный класс для выбранного объекта#Назначить класс для объекта
ObjectSpline=Объект сплайном#Измерения#Shift-добавление, Alt-вычитание, завершение-двойное нажатие левой кнопки#Объект сплайном
ObjectSplineScript=ObjectSplineScript#Скрипты#ObjectSplineScript
ObjectSplineScript_Old2006=ObjectSplineScript_Old2006#Скрипты#ObjectSplineScript_Old2006
ObjectTouch=Make object last in type#Edit#Make object last in type#Make object last in type
ObjectsExport=Export objects list#Edit#Export objects list#Export objects list
ObjectsMakeLight=Облегчить объекты#Правка#Облегчить объекты#Облегчить объекты
ObjectsMerge=Объединить два списка объектов#Измерения#Объединить два списка объектов#Объединить два списка объектов
ObjectsRemove=Удалить все объекты выбранного класса#Правка#Удалить все объекты выбранного класса#Удалить все объекты выбранного класса
ObjectsSetClass=Назначить класс для всех объектов в списке#Правка#Назначить класс для всех объектов в списке#Назначить класс для всех объектов в списке
ObjectsSplit=Разделить объекты на классы#Правка#Разделить объекты на классы#Разделить объекты на классы
Open=Открытие#Фильтры#Применить фильтр Открытие к активному изображению#Открытие
OpenByReconstruction=Open by Reconstruction#Filters#Open by reconstruction
OpenByReconstructionAAM=Открытие с реконструкцией#Преобразования#Открытие с реконструкцией
OpenDataBase=Open Database...#Database#Open existing database#Open Database
OpenLastDB=Open Last Database...#Database#Open last used database#Open Last Database
OpenQuery=Открыть запрос#База данных#Открыть запрос#Открыть запрос
OptionsMaster=Options...#Tools#Main program options#Main Options
OverlaySection=График яркости от точки до точки#Измерения#Создать новый график яркости от точки до точки на изображении#График яркости от точки до точки
OverlaySectionHorz=Горизонтальный график по яркости#Измерения#Создать новый горизонтальный график по яркости на изображении#Горизонтальный график по яркости
OverlaySectionVert=Вертикальный график по яркости#Измерения#Создать новый вертикальный график по яркости на изображении#Вертикальный график по яркости
PackPhase=pack phase#Phase analysis#pack phase
PageSetup=Параметры страницы...#Печать#Параметры страницы#Параметры страницы
ParticlesAddFrame=ParticlesAddFrame#Particles#ParticlesAddFrame
PasteAsNew=Paste into New Document#Edit#Paste into new document#Paste into New Document
PeaksThreshold=Бинаризация по пикам#Filters#Бинаризация по пикам гистограммы
PickColor=Пипетка#Редактор#Выбор цвета на изображении: правая или левая кнопки мыши#Пипетка
Print=Печать#Печать#Печать активного документа#Печать
PrintDesignMode=Конструктор шаблона отчета...#Печать#Создать шаблон отчета#Конструктор шаблона отчета
PrintPreview=Предварительный просмотр...#Печать#Предварительный просмотр отчета перед печатью#Предварительный просмотр
PrintTemplateDelete=Удалить шаблон отчета...#Печать#Удалить шаблон отчета#Удалить шаблон отчета
PrinterSetup=Настройка печати...#Печать#Настройка печати#Настройка печати
ProcessPairs=ProcessPairs#Filters#ProcessPairs
Pyramid=Пирамидальная сегментация#Filters#Пирамидальная сегментация
QueryWizard=Свойства запроса...#База данных#Свойства запроса#Свойства запроса
ReCalcOnChangeCalibr=Перемерить объекты#Измерения#Перемерить объекты в соответствии с выбранной калибровкой#Перемерить объекты
ReadCoords=read coords#File#read coords#read coords
RecordInfo=Информация о записи#База данных#Информация о записи#Информация о записи
Redo=Повторить#Правка#Повторить последнюю ранее отмененную операцию#Повторить
Relaxation=Бинаризация с релаксацией#Filters#Бинаризация с релаксацией
RemoveAllSortFields=Отменить все сортировки#База данных#Отменить все сортировки#Отменить все сортировки
RemoveMMObjects=Удалить все#Измерения#Удаление всех результатов ручных измерений из активного списка#Удалить все
RemoveMtdPane=RemoveMtdPane#Method#RemoveMtdPane#RemoveMtdPane
RemoveParam=Удалить столбец ручных измерений#Измерения#Удаление выбранных результатов ручных измерений из списка объектов#Удалить столбец ручных измерений
RemoveUnknClass=Delete Unknown#Measurement#Delete all unknown objects#Delete All Unknown Objects
RemoveView=Удалить вид отображения из разделителя окна#Internal Actions#Удалить вид отображения из разделителя окна#Удалить вид отображения из разделителя окна
RenameMethod=Rename Method#Method#Rename the selected method#Rename Method
RenameMethod_Old2006=Rename Method#Method#Rename the selected method#Rename Method
RenameView=Переименовать вид отображения в разделителе окна#Internal Actions#Переименовать вид отображения в разделителе окна#Переименовать вид отображения в разделителе окна
ReportEditText=Редактировать текст в выбранном поле#Печать#Редактировать текст в выбранном поле#Редактировать текст в выбранном поле
Requery=Перезапустить запрос#База данных#Перезапустить запрос#Перезапустить запрос
RequestForDB=Запрос данных для базы#Edit#Запрос значений пользовательских полей для базы данных#Запрос данных для базы
RequestForPrint=Запрос данных для печати#Edit#Запрос значений пользовательских полей для печати#Request Values For Printing
RequestForPrintSD=Запрос данных для печати по ShellData#Edit#Запрос значений пользовательских полей для печати по ShellData#Request Values For Printing from ShellData
Resize=Изменить размер#Правка#Изменить размера изображения#Изменить размер
ResizeBin=ResizeBin#Binary#ResizeBin#ResizeBin
RestoreDatabase=Восстановить базу данных#База данных#Восстановить базу данных#Восстановить базу данных
RestoreSel=restore selection#По умолчанию#restore selection#RestoreSel
Rotate=Произвольный поворот...#Изображение#Произвольный поворот изображения#Произвольный поворот
Rotate180=Повернуть на 180#Изображение#Поворот изображения на 180 градусов#Повернуть на 180
Rotate270=Повернуть на 270#Изображение#Поворот изображения на 270 градусов#Повернуть на 270
Rotate90=Повернуть на 90#Изображение#Поворот изображения на 90 градусов#Повернуть на 90
RunBinMorph=Mask Morphology...#Objects Masks#Morphological operations on the object masks on the image#Morphological Operations on the Object Masks
RunBrightnessContrastLight=Brightness and Contrast...#Enhance#Adjust brightness and contrast of the active image#Brightness and Contrast
RunBrightnessContrastLight_Old2006=Brightness and Contrast...#Enhance#Adjust brightness and contrast of the active image#Brightness and Contrast
RunCalibrXYRatio=Input Device X/Y Ratio...#Measurement#Specify X/Y pixel ratio for active input device#Input Device X/Y Ratio
RunClass=Classifier...#Statistics#Classifier#Classifier
RunColorAutoThresholding=Automatic...#Objects Masks#Automatic objects masks thresholding on image#Automatic Objects Masks Thresholding
RunColorBalance=Color Balance...#Enhance#Apply the Color Balance filter to the image#Color Balance
RunColorBalance_Old2006=Color Balance...#Enhance#Apply the Color Balance filter to the image#Color Balance
RunColorManualThresholding=By Specified Points...#Objects Masks#Manual objects mask thresholding per color and brightness samples#Objects Mask Thresholding by Specified Points
RunColorPhaseThresholding=Phase Detection...#Objects Masks#Automatic phase detection on image#Automatic Phase Detection
RunCreateEmptyImage=Create Empty Image...#File#Create an empty image in the active document#Create Empty Image
RunCreateParam=New Column...#Measurement#Add new column to measurement data table#New Column
RunDataBaseDesign=Form Design...#Database#Form design and database editing#Form Design
RunDataBaseDesign_Old2006=Form Design...#Database#Form design and database editing#Form Design
RunDivide=Mask Separation...#Objects Masks#Automatic object masks separation on image#Automatic Object Masks Separation
RunEdgeDetection=Edge Detection...#Enhance#Apply the Edge Detection filter to the image#Edge Detection
RunEdgeDetection_Old2006=Edge Detection...#Enhance#Apply the Edge Detection filter to the image#Edge Detection
RunEditMarker=Free-Length Calibration Bar#Measurement#Free-Length Calibration Bar#Free-Length Calibration Bar
RunEnchancedFocus=RunEnchancedFocus#Скрипты#RunEnchancedFocus
RunEqualize=Equalize...#Enhance#Equalize the active image#Equalize
RunEqualize_Old2006=Equalize...#Enhance#Equalize the active image#Equalize
RunEven2=Background Correction...#Enhance#Adjust background correction image filter#Background Correction
RunEven2_Old2006=Background Correction...#Enhance#Adjust background correction image filter#Background Correction
RunFocus=RunFocus#Скрипты#RunFocus
RunFocus_Old2006=RunFocus_Old2006#Скрипты#RunFocus_Old2006
RunGrayThresholding=By Brightness...#Objects Masks#Objects masks thresholding by brightness#Objects Masks Thresholding by Brightness
RunInfo=Image Information...#Image#Image Information#Image Information
RunMarker=Fixed-Length Calibration Bar...#Measurement#Fixed-length calibration bar#Fixed-Length Calibration Bar
RunMeasParameters=Measurement Parameters...#Measurement#Measurement parameters selection#Measurement Parameters
RunMethodSetup=Method Settings...#Method#Method settings#Method Settings
RunMorphology=Morphological Filters...#Image#Morphological operations on source image#Morphological Filters
RunMorphology_Old2006=Morphological Filters...#Image#Morphological operations on source image#Morphological Filters
RunNewCalibr=New Calibration...#Measurement#Create new calibration#New Calibration
RunODSetBackgr1=Настройка фона...#Измерения#Настройка фона оптической плотности#Настройка фона оптической плотности
RunODSetttings2=Настройка оптической плотности...#Измерения#Настройка оптической плотности#Настройка оптической плотности
RunODSetttings3=Настройка оптической плотности...#Измерения#Настройка оптической плотности#Настройка оптической плотности
RunOptionsCalibr=Select Calibration...#Measurement#Select calibration or change units of measure#Select Calibration
RunOptionsDBMaster=Interaction with DB...#Database#Specify fields for interaction with database#Interaction with Database
RunOptionsManualColor=RunOptionsManualColor#Скрипты#RunOptionsManualColor
RunOptionsManualMeas=RunOptionsManualMeas#Скрипты#RunOptionsManualMeas
RunOptionsManualMeasStat=RunOptionsManualMeasStat#Скрипты#RunOptionsManualMeasStat
RunOptionsStitch=Stitch Options...#Image#Stitch options#Stitch Options
RunOptionsStitch_Old2006=Stitch Options...#Image#Stitch options#Stitch Options
RunResize=Resize...#Image#Resize the active image#Resize Image
RunScript=Командная строка...#Сервис#Run the script#Командная строка
RunSelectCellPloidType=Выбор типа нормальных клеток...#Measurement#Выбор типа нормальных клеток#Выбор типа нормальных клеток
RunSetupBorders=Add Borders...#Image#Add borders to the image#Add Borders
RunSmooth=Smooth...#Enhance#Apply smoothing filter to the image#Smooth
RunSmooth_Old2006=Smooth...#Enhance#Apply smoothing filter to the image#Smooth
RunStat=RunStat#Скрипты#RunStat
RunStat1=RunStat1#Скрипты#RunStat1
RunStatGraphAxis=Axes...#Statistics#Axes#Axes
RunStatGraphCompare=Compare...#Statistics#Compare#Compare
RunStatGraphDepend=Dependence...#Statistics#Dependence#Dependence
RunStatGraphDistr=Statistics...#Statistics#Statistics#Statistics
RunStatGraphDistrOptions=Titles...#Statistics#Titles#Titles
RunStatSelect=Sample...#Statistics#Sample#Sample
RunStat_Old2006=RunStat_Old2006#Скрипты#RunStat_Old2006
RunSupport=Technical Support#Help#Technical support#Technical Support
RunTemplatesManagerDBMaster=Database Print Template Manager...#Print#Manage print templates#Print Template Manager
RunTemplatesManagerMaster=Print Template Manager...#Print#Manage print templates#Print Template Manager
RunTestWindow=RunTestWindow#Tests#run test window#RunTestWindow
RunTimerInput=Timer Input#Acquire#Input a number of frames at specified intervals#Timer Input
RunTimerInput_Old2006=Timer Input#Acquire#Input a number of frames at specified intervals#Timer Input
RunUnsharpen=Unsharp Mask...#Enhance#Increase the overall sharpness of the image#Unsharp Mask
RunUnsharpen_Old2006=Unsharp Mask...#Enhance#Increase the overall sharpness of the image#Unsharp Mask
RunUserMeasParamEdit=User Defined Parameters...#Measurements#User defined measurement parameters#User Defined Parameters
SaveFilter=Сохранить фильтр#База данных#Сохранить фильтр#Сохранить фильтр
SaveImageFromDB=Save Image...#File#Save source image to file#Save Image
SaveObjects=SaveObjects#Скрипты#SaveObjects
SaveViewState=Сохранить сотояние вида отображения\Internal Actions#Сохранить сотояние вида отображения#Сохранить сотояние вида отображения#Сохранить сотояние вида отображения
Scissors=Ножницы#Карио#Разделение хромосом. Рисовать при нажатой левой кнопке мыши, отпустить кнопку - завершение.#Separate objects
ScriptChange=Заменить скрипт#Edit#Заменить скрипт#Заменить скрипт
ScriptExecute=Выполнить скрипт#Script#Выполнить скрипт#Выполнить скрипт
ScriptTerminate=Остановить скрипт#Script#Остановить скрипт#Остановить скрипт
SegmColorPhases=Поиск цветовых диапазонов#Filters#Поиск цветовых диапазонов
SegmLines=SegmLines#Particles#SegmLines
SegmObjects=SegmObjects#Particles#SegmObjects
SegmSerial=SegmSerial#Thresholding#SegmSerial
SegmSerial2=SegmSerial2#Thresholding#SegmSerial2
SegmSerial3=SegmSerial3#Thresholding#SegmSerial3
SegmSmallObjects=SegmSmallObjects#Particles#SegmSmallObjects
SelectAdd=Добавить рамку#Рамки#Добавить новую рамку к активной#Добавить рамку
SelectAll=Выделить все#Рамки#Нанести рамку на все изображение#Выделить все
SelectArea=Произвольная рамка#Рамки#Завершение-двойное нажатие левой кнопки мыши, Shift-добавление, Alt-вычитание#Произвольная рамка
SelectEllipse=Круглая рамка#Рамки#Используйте Shift для добавления и Alt для вычитания рамки#Круглая рамка
SelectFixedRect=Фиксированная прямоугольная рамка#Рамки#Shift-добавление, Alt-вычитание, Ctrl-перекрестие#Фиксированная прямоугольная рамка
SelectInputDeviceMaster=Select Device and Input...#Acquire#Select device and input image into a new document#Select Device and Input
SelectInputMethod=SelectInputMethod#Скрипты#SelectInputMethod
SelectInvert=Инвертировать рамку#Рамки#Инвертировать активную рамку#Инвертировать рамку
SelectMakeVirtual=Виртуализировать рамку#Internal Actions#Виртуализировать рамку#Виртуализировать рамку
SelectRect=Прямоугольная рамка#Рамки#Shift-добавление, Alt-вычитание, Ctrl-перекрестие#Прямоугольная рамка
SelectRemove=Удалить рамку#Рамки#Удалить новую рамку из активной#Удалить рамку
SelectSmooth=Сглаживание рамки#Рамки#Сглаживание рамки#Сглаживание рамки
SendSrcImageToDB=Source Image to DB#Database#Send sourse image to database by interaction settings#Send Source Image to DB
SendSrcImageToDB_Old2006=Source Image to DB#Database#Send sourse image to database by interaction settings#Send Source Image to DB
SendTo=Отправить в...#Сервис#Отправить активный элемент в другой открытый документ#Отправить в
SendToDB=Send to Database#Database#Send data to new database record#Send to New Database Record
SendToDBAllTypes=All Elements to DB#Database#Send all elements to database by interaction settings#Send All Elements to DB
SendToDBAllTypes_Old2006=All Elements to DB#Database#Send all elements to database by interaction settings#Send All Elements to DB
SendToDBToActiveField=To Active DB Field#Database#Send active element to active database field#Send to Active DB Field
SendToDBToActiveField_Old2006=To Active DB Field#Database#Send active element to active database field#Send to Active DB Field
SendToDB_Old2006=Send to Database#Database#Send data to new database record#Send to New Database Record
SetActiveClass=Активизировать класс#Classification#Выбрать класс и активизировать его#Активизировать класс
SetBrightnessPanes=Set Panes for Brightness#Internal Scripts#Set Panes for Brightness#Set Panes for Brightness
SetClass=Назначить класс#Правка#Назначить класс для выбранного объекта
SetListZOrder=SetListZOrder#Измерения#SetListZOrder#SetListZOrder
SetZOrder=SetZOrder#Edit#SetZOrder#SetZOrder
SewAuto=Автоматическая горизонтальная сшивка#Изображение#Автоматическая сшивка пронумерованных  изображений слева на право
SewAuto2=Auto Stitch#Image#Stitch selected images automatically
SewAutoVert=Автоматическая вертикальная сшивка#Изображение#Автоматическая сшивка пронумерованных  изображений сверху вниз
SewManual=Ручная сшивка#Изображение#Перемещение: Shift+стрелки курсора. Быстрое перемещение: Сtrl + стрелки курсора. Выход: Esc.
SewStatTable=Sew Statistics Table#Statistics#Sew statatistics table
Sharping=Резкость#Фильтры#Применить фильтр Резкость к активному изображению#Резкость
Sharpness=Sharpness#Фильтры#Sharpness
ShowAllStatTableColumns=Show All Statistics Table Columns#Statistics#Show all statatistics table columns
ShowApportionment=Показать распределение#Вид#Показать распределение
ShowAviGallery=Показать галерею AVI#AVI#Показать галерею AVI
ShowBinary=Бинарное изображение#View#Показать бинарное изображение#Бинарное изображение
ShowBinaryBack=Трейсы на фоне#Вид#Показать трейсы на фоне#Трейсы на фоне
ShowBinaryContour=Показать бинарное с контурами#View#Показать бинарное изображение с контурами#Показать бинарное с контурами
ShowBinaryFore=Трейсы на исходном изображении#Вид#Показать трейсы на исходном изображении#Трейсы на исходном изображении
ShowBlankDesign=Конструктор бланка#База данных#Конструктор бланка#Конструктор бланка
ShowBlankPreview=Бланк#База данных#Показать записи в виде бланков#Показать бланк
ShowCalibr=Показать маркер#View#Показать калибровочный маркер на изображении#Показать маркер
ShowCfg=Configuration#Statistics#Show/hide Configuration bar#Show/hide Configuration bar
ShowClassLabels=Show Class Labels#Tools#Show/hide labels of classes#Show Class Labels
ShowClassView=Показать классы#Вид#Показать классы#Показать классы
ShowCompareView=Сравнение статистик#Вид сравнеия#Показать сравнение
ShowContext=Окно Содержание#Вид#Показать окно Содержание документа#Окно Содержание
ShowContextscript=Context Viewer#Tools#Show/hide Context Viewer#Context Viewer
ShowDBGrid=Таблица#База данных#Показать запрос в виде таблицы#Показать таблицу
ShowDockBars=Show Dockbars#Internal Scripts#Show dockbars#
ShowDockBars_Old2006=Show Dockbars#Internal Scripts#Show dockbars#
ShowGallery=Галерея#База данных#Показать записи в виде галереи#Показать галерею
ShowHistogram=Histogram#Tools#Show/hide Histogram bar#Histogram
ShowHistogram_Old2006=Histogram#Tools#Show/hide Histogram#Histogram
ShowImage=Изображение с контурами#Вид#Показать изображение с контурами объектов#Изображение с контурами
ShowImageAnnotation=Annotation#Tools#Show/hide Annotation toolbar#Annotation
ShowImageAnnotation_Old2006=Annotation#Tools#Show/hide Annotation toolbar#Annotation
ShowLayout=Показать расположение элементов оформления#Расположение#Показать расположение элементов оформления#Показать расположение элементов оформления
ShowMainToolBar=Main#Tools#Show/hide Main toolbar#Main
ShowMasks=Маски объектов#Вид#Показать изображение с масками объектов#Маски объектов
ShowMeasManual=Manual Measurements#Tools#Show/hide Manual Measurements toolbar#Manual Measurements
ShowMeasManual_Old2006=Manual Measurements#Tools#Show/hide Manual Measurements toolbar#Manual Measurements
ShowMeasView=Таблица измерений#Вид#Показать результаты измерений#Таблица измерений
ShowMethodPanel=Method Bar#Tools#Show/hide Method bar#Method Bar
ShowMetodicsTab=Fucntion Bar#Tools#Show/hide Fucntion bar#Fucntion Bar
ShowMtdListToolBar=Method List#Tools#Show/hide Method List toolbar#Method List
ShowObjectEditor=Object Editor#Tools#Show/hide Object Editor toolbar#Object Editor
ShowObjectEditor_Old2006=Object Editor#Tools#Show/hide Object Editor toolbar#Object Editor
ShowObjects=Объекты на фоне#Вид#Показать изображение с обектами на фоне#Объекты на фоне
ShowOleObject=Показать OLE объект#OLE объект#Показать OLE объект
ShowOleObjectContent=О создании OLE объекта#OLE объект#Информация о создании OLE объекта
ShowOptions=Установки...#Tools#Изменить установки программы#Установки
ShowPhase=Показать фазы#Вид#Показать фазы#Показать фазы
ShowPreview=Видео#Вид#Просмотр "живого видео" с видеоустройства#Видео
ShowPreviewIndirect=Просмотр отчета#Печать#Предварительный просмотр отчета перед печатью#Просмотр отчета
ShowPropertyBar=Properties Page#Tools#Show/hide Properties page#Properties Page
ShowPseudo=Цветокодированное изображение#Вид#Показать цветокодированное изображение#Цветокодированное изображение
ShowScript=Показать скрипт#View#Показать скрипт#Показать скрипт
ShowSelectionToolBar=Selection#Tools#Show/hide Selection toolbar#Selection
ShowSelectionToolBar_Old2006=Selection#Tools#Show/hide Selection bar#Selection
ShowSource=Исходное изображение#Вид#Показать исходное изображение#Исходное изображение
ShowStatChartCmp=Show/Hide Compare Chart#Statistics#Show/Hide statistics comparison chart
ShowStatChartView=Показать диаграмму#Статистика#Включить/выключить отображение столбцовой диаграммы
ShowStatInfo=Info#Statistics#Show/hide Info bar#Show/hide Info bar
ShowStatLegendCmp=Show/Hide comparison legend#Statistics#Show/hide statistic legend
ShowStatLegendView=Показать легенду#Статистика#Включить/выключить отображение легенды
ShowStatTable=Таблица данных#Вид#Показать таблицу данных
ShowStatTableCmp=Show/Hide comparison table#Statistics#Show/Hide statistic comparison table
ShowStatTableDependence=Зависимость#Вид#Показать зависимость
ShowStatTableView=Показать таблицу#Статистика#Включить/выключить отображение таблицы
ShowStatView=Статистика#Вид#Показать статистику
ShowThumbnail=Показать кадр#Data#Показать кадр#Показать кадр
ShowToolsCustomize=Customize...#Tools#Customize the program interface - toolbars, menus etc.#Customize
ShowVersion=Show Version...#File#Show version#Show Version
ShowView=Показать вид с использованием программного идентификатора#View#Показать вид с использованием программного идентификатора#Показать вид с использованием программного идентификатора
ShowVirtualClasses=ShowVirtualClasses#Statistics#ShowVirtualClasses
Signature=Signature#Security#Signature
Sleep=sleep#For Developers#sleep
SmoothContour=Сглаживание контуров масок#Filters#Сглаживание контуров масок
SmoothMasks=Сглаживание контуров масок#Фильтры#Сгладить контуры масок объектов#Сглаживание масок
Snapshot=Snapshot#Tests#Snapshot
SpermSegm=SpermSegm#Particles#SpermSegm
StartDebugger=Запустить программу отладки#Script#Запустить внешнюю программу отладки#Запустить программу отладки
StatDataToExcel=Statistical Table to MS Excel#Measurement#Send active statistical table to MS Excel#Send Statistical Table to MS Excel
StatDataToExcel_Old2006=Таблицу статистики в MS Excel#Измерения#Отправить активную таблицу статистики в MS Excel#Отправить таблицу статистики в MS Excel
StatRemove=Delete Table#Statistics#Delete data table#Delete Data Table
StoreForPrint=Запись данных для печати#Edit#Запись значений пользовательских полей для печати#Store Values For Printing
StoreMtdContent=StoreMtdContent#Method#StoreMtdContent#StoreMtdContent
SwitchPhase=Переключение фазы на активном фазовом изображении#Фазовый анализ#Переключение фазы на активном фазовом изображении
SyncContext=Синхронизация содержания#Окно#Синхронизация содержания и видов отображения#Синхронизация содержания
SyncContextAll=Синхронизация содержания#Окно#Синхронизация содержания и видов отображения#Синхронизация содержания
SyncEdit=Синхронное редактирование#Вид#Синхронизировать операции редактирования#Синхронное редактирование
SyncScroll=Синхронизация изображений#Окно#Синхронизация изображений (если окно документа разделено)#Синхронизация изображений
SyncScrollRelative=Относительная синхронизация изображений#Окно#Относительная синхронизация изображений (если окно документа разделено)#Относительная синхронизация изображений
SyncZoom=Синхронизация изображений и увеличений#Окно#Синхронизация изображений и увеличений (если окно документа разделено)#Синхронизация изображений и увеличений
TV5=Capture#Acquire#Capture an image from video device#Capture
TVInputCurrent=Input into Active...#Acquire#Input image into the active document#Input Image into Active Document
TVInputNew=Input into New...#Acquire#Input image into a new document without device selection#Input into New Document
TableWizard=Структура базы данных...#База данных#Структура базы данных#Структура базы данных
TailEdit=Редактирование хвоста#Particles#Редактирование хвоста (левая кнопка мыши) и средней части (Shift+лев. кнопка мыши)
TakeObjectsRects=TakeObjectsRects#Particles#TakeObjectsRects
TeachClassifier=Обучить классификатор#Классификация#Обучение классификатора по обучающей базе
TeachNeuro=TeachNeuro#neuro#TeachNeuro
TemplateSetup=Установки шаблона...#Печать#Установки шаблона#Установки шаблона
ThresholdByEdges=ThresholdByEdges#Thresholding#ThresholdByEdges
ToEn=ToEn#Скрипты#ToEn
ToRu=ToRu#Скрипты#ToRu
ToggleBreakpoint=Включить/выключить точку останова#Script#Включить/выключить точку останова#Включить/выключить точку останова
ToolsCustomize=Настройка...#Сервис#Настройка интерфейса программы-панелей инструментов, меню и т. д.#Настройка
ToolsLoadState=Загрузить состояние панелей и меню...#Сервис#Загрузить состояние панелей и меню#Загрузить состояние панелей и меню
ToolsLoadStateEx=Загрузить состояние панелей и меню...#Сервис#Загрузить состояние панелей и меню#Загрузить состояние панелей и меню
ToolsSaveAsState=SaveAs State...#Tools#SaveAs the program interface - toolbars, menus etc.#SaveAs State
ToolsSaveState=Сохранить состояние панелей и меню...#Сервис#Сохранить интерфейс программы  - панели инструментов, меню и т.д.#Сохранить состояние панелей и меню
TopHat=TopHat#Filters#TopHat
TrainClassifier=TrainClassifier#ClassBase#TrainClassifier
TransformColor1=TransformColor1#Color#TransformColor1
TransformationByPoints=Совместить точки на изображениях#Изображение#Совместить реперные точки на изображениях. Установите на каждом изображении соответствующие точки. Двойное нажатие - завершение операции#Совмещение точек
TriggerMode=Ввод по триггеру#Ввод#Ввод изображения по внешнему сигналу#Ввод по триггеру
TriggerSequence=Последовательный ввод по внешнему сигналу#Ввод#Последовательный ввод по внешнему сигналу#Последовательный ввод по внешнему сигналу
UltimateErosion=UltimateErosion#Binary#UltimateErosion#UltimateErosion
UnEqualizeObj=Отменить контраст#Преобразования#Отменить контрастирование выбранной хромосомы - левая кнопка мыши, выход - Esc.
Undo=Отменить#Правка#Отменить последнюю выполненную операцию#Отменить
UnpackPhase=unpack phase#Phase analysis#unpack phase
UnsharpenMask=Усиление резкости#Фильтры#Усиление общей резкости изображения#Усиление резкости
Update=Обновить#База данных#Обновить базу данных#Обновить
UpdateOleObject=Обновить OLE объект#OLE объект#Обновить OLE объект
UpdateRecordsetInfo=UpdateRecordsetInfo#База данных#UpdateRecordsetInfo#UpdateRecordsetInfo
UpdateWindow=UpdateWindow#For Developers#UpdateWindow
Variance=Вариации#Filters#Вариации
Watermark=Watermark#Security#Watermark
WindowActivate=Активизировать окно#Окно#Активизировать окно#Активизировать окно
WindowArrange=Упорядочить#Окно#Упорядочить значки#Упорядочить
WindowCascade=Расположить окна каскадом#Окно#Расположить окна каскадом#Расположить окна каскадом
WindowClose=Закрыть окно#Окно#Закрыть активное окно#Закрыть окно
WindowNew=Новое окно#Окно#Открыть новое окно#Новое окно
WindowTile=Расположить окна мозаикой#Окно#Расположить окна мозаикой#Расположить окна мозаикой
Wnd2Meas=Split and Synchronize#Window#Split document window vertically, show image and its Measurement Data#Split and Synchronize
Zoom=Лупа#Вид#Левая кнопка мыши: увеличение, +Shift: уменьшение, правая кнопка: исх. изображение#Лупа
Zoom12=Увеличение 1:2#Вид#Увеличить изображение 1:2#Увеличение 1:2
Zoom13=Увеличение 1:3#Вид#Увеличить изображение 1:3#Увеличение 1:3
Zoom14=Увеличение 1:4#Вид#Увеличить изображение 1:4#Увеличение 1:4
Zoom21=Уменьшение 2:1#Вид#Уменьшить изображения 2:1#Уменьшение 2:1
Zoom31=Уменьшение 3:1#Вид#Уменьшить изображение 3:1#Уменьшение 3:1
Zoom41=Уменьшение 4:1#Вид#Уменьшить изображение 4:1#Уменьшение 4:1
ZoomFit=Set Fit to Window On#View#Set Fit to Window On#Set Fit to Window On
ZoomIn=Увеличение#Вид#Увеличить изображение#Увеличение
ZoomInTable=Увеличить на 10 %#Вид#Увеличить на 10 %#Увеличить на 10%
ZoomNormal=Увеличение 1:1#Вид#Увеличить изображение 1:1#Увеличение 1:1
ZoomOut=Уменьшение#Вид#Уменьшение изображения#Уменьшение
ZoomOutTable=Уменьшить на 10 %#Вид#Уменьшить на 10 %#Уменьшить на 10 %
add_functions=add_functions#Скрипты#add_functions
add_functions_Old2006=add_functions_Old2006#Скрипты#add_functions_Old2006
add_functions_db=add_functions_db#Скрипты#add_functions_db
add_functions_db_Old2006=add_functions_db_Old2006#Скрипты#add_functions_db_Old2006
add_functions_object_keys=add_functions_object_keys#Скрипты#add_functions_object_keys
add_functions_object_keys_Old2006=add_functions_object_keys_Old2006#Скрипты#add_functions_object_keys_Old2006
blot=blot#Скрипты#blot
